tttttttttttt
ttt*****  tt
tt*    *  tt
tt* t# * ott
tt*     #ott
tt*    *  tt
tt**   *p tt
ttt*****tttt
tttttttttttt