tttttttttttt
ttt*****  tt
ttt    *  tt
ttt  o #o tt
tt***#tt  tt
tt*   tt#ttt
tt*     o tt
ttt p *   tt
tttttttttttt
tttttttttttt